
11111111111111111111111111111
11100000101110000010000000001
10110000100000000010000010001
1001000010000N000010000010001
10110000000000000000000010001
10000000001100000111011110001
11110111111111011100000010001
11110111111111011101010010001
11000000110101011100000010001
10001000000000001100000010001
10000000000000001101010010001
11000000110101011111011110001
11111011111101011111011110001
11111111111111111111111111111
11111111111111111111111111111



11111111111111111111111111111
1E000000101110000010000000001
10000200000010000010000010001
10010000020000100010020010001
10110000000001000000000010001
10000000001100000111011110001
11110111111111011100000010001
11110111111111011101010010001
11000000110101011100000010001
10000000000000001100000010001
10000200000000001101010010001
11000000110101011111011110001
11111011111101011111011110001
11111111111111111111111111111
11111111111111111111111111111
