R 1000 700
EA ./textures/dark.xpm
NO ./textures/pink.xpm
SO ./textures/purple.xpm
WE ./textures/snow.xpm

S ./textures/sans.xpm

C 94,84,146
F 57,56,82

11111111111111111111111111111
1E000000101110000010000000001
10010200000010000010000010001
10010000020000100010020010001
10110020000001000000000010001
10000000001100000111011110001
11110000011111011100000010001
11110001111111011101010010001
11000000110101011100000010001
10000000000020000000000010001
10000200000000001101010010001
11000000110101011111011110201
11111011111101011111011110001
11111111111111111111111111111
11111111111111111111111111111