R 3000 2000

EA ./textures/dark.xpm
NO ./textures/pink.xpm
SO ./textures/purple.xpm
WE ./textures/snow.xpm

S ./textures/sans.xpm
C 94,84,146
F 57,56,82

11111111111
10000S00001
11111111111
