R 1000 700

EA ./textures/dark.xpm
NO ./textures/pink.xpm
SO ./textures/purple.xpm
WE ./textures/snow.xpm

S ./textures/sans.xpm
C 94,84,146
F 57,56,82

111111111111
120202020201
100000000001
100000N00001
111111111111
