R 767 545
EA ./textures/dark.xpm
NO ./textures/pink.xpm
SO ./textures/purple.xpm
WE ./textures/snow.xpm

S ./textures/sans.xpm
C 94,84,146
F 57,56,82

11111111111111111111111111111
11100000101110000010000000001
10110000100N00000010000010001
10010000100000000010000010001
10110000000000000000000010001
10000000001100000111011110001
11110111111111011100000010001
11110111111111011101010010001
11000000110101011100000010001
10000000000000001100000010001
10000000000000001101010010001
11000000110101011111011110001
11111011111101011111011110001
11111111111111111111111111111
11111111111111111111111111111
