R 567 345
EA ./textures/dark.xpm
NO ./textures/pink.xpm
SO ./textures/purple.xpm
WE ./textures/snow.xpm

S ./textures/sans.xpm
F 0,255,235
C 26,5,30

11111111111111111111111111111
11100000001110000000000000001
10110000000000000010000010001
10010000000000N00000000010001
10110000000000000000000010001
10000000001100000111011110001
11110111111111011100000010001
11110111111111011101010010001
11000000110101011100000010001
10001000000000001100000010001
10000000000000001101010010001
11000000110101011111011110001
11111011111101011111011110001
11111111111111111111111111111