R 567 345
EA ./textures/dark.xpm
NO ./textures/pink.xpm
SO ./textures/purple.xpm
WE ./textures/snow.xpm

S ./textures/sans.xpm
C 163,73,164
F 255,127,0

11011
11111
10001
10001
10011
10001
10011
1N001
111111