R 1067 745
EA ./textures/dark.xpm
NO ./textures/pink.xpm
SO ./textures/purple.xpm
WE ./textures/snow.xpm

S ./textures/barrel.xpm
C 94,84,146
F 57,56,82

1111
1001
1201
1201
1201
1221
1N01
1001
1111

