R 1000 700
EA ./textures/dark.xpm
NO ./textures/pink.xpm
SO ./textures/purple.xpm
WE ./textures/snow.xpm

S ./textures/sans.xpm

C 94,84,146
F 57,56,82

1111111111
1222222221
1222222221
1222N22221
1111111111